#####B#
##### #
##### #
#     #
####  #
#     #
#### ##
     ##
A######
