##    #
## ## #
# #  #
# ## ##
     ##
 ######
